10X10
.../.....C
././.B.../
Z/....RU.S
.///.BU..B
./........
.Z.//..E.H
./.C.....C
./..//..R.
.././/.//.
B//.......