10X10
...../C///
.C..././/E
..........
..C../....
B....///C.
......C../
/./...////
...S../...
///..././.
///.......