10X10
C....C.../
./.B.///./
.../......
././././..
.E.B./....
....C..C..
...C../S..
.../......
//...././.
//........