10X10
..........
.//.//../.
...C//....
///././.E.
//.......C
.././//./.
/././//CB.
.C../.....
/.BSBC/./.
B...../...